111111111111111111111111111111111111111
1000000P000000000000000000C0000S000E001
100S000000000000C000000S0000000C0000001
111111111111111111111111111111111111111